"aa" = (/turf/unsimulated/wall,/area/acting/backstage)
"ab" = (/turf/space,/area/space)
"ac" = (/obj/effect/landmark{name = "ActorSpawn"},/turf/unsimulated/floor{icon_state = "plating"; name = "plating"},/area/acting/backstage)
"ad" = (/obj/machinery/acting/wardrobe,/turf/unsimulated/floor{icon_state = "plating"; name = "plating"},/area/acting/backstage)
"ae" = (/obj/structure/table/rack,/obj/item/weapon/storage/box/lights/mixed,/obj/item/device/floor_painter,/turf/unsimulated/floor{icon_state = "plating"; name = "plating"},/area/acting/backstage)
"af" = (/obj/structure/table/rack,/obj/item/stack/tile/floor{amount = 50},/obj/item/stack/tile/floor{amount = 50},/turf/unsimulated/floor{icon_state = "plating"; name = "plating"},/area/acting/backstage)
"ag" = (/obj/structure/table/rack,/obj/item/stack/tile/floor_freezer{amount = 50},/obj/item/stack/tile/floor_freezer{amount = 50},/turf/unsimulated/floor{icon_state = "plating"; name = "plating"},/area/acting/backstage)
"ah" = (/obj/structure/table/rack,/obj/item/stack/tile/carpet{amount = 50},/obj/item/stack/tile/carpet{amount = 50},/turf/unsimulated/floor{icon_state = "plating"; name = "plating"},/area/acting/backstage)
"ai" = (/obj/structure/table/rack,/obj/item/stack/tile/grass{amount = 50},/obj/item/stack/tile/grass{amount = 50},/turf/unsimulated/floor{icon_state = "plating"; name = "plating"},/area/acting/backstage)
"aj" = (/obj/structure/table/rack,/obj/item/stack/material/steel{amount = 50; pixel_x = 5; pixel_y = 5},/obj/item/stack/material/steel{amount = 50; pixel_x = 5; pixel_y = 5},/obj/item/stack/material/steel{amount = 50; pixel_x = 5; pixel_y = 5},/turf/unsimulated/floor{icon_state = "plating"; name = "plating"},/area/acting/backstage)
"ak" = (/obj/structure/table/rack,/obj/item/stack/material/plasteel{amount = 50},/obj/item/stack/material/plasteel{amount = 50},/obj/item/stack/material/plasteel{amount = 50},/turf/unsimulated/floor{icon_state = "plating"; name = "plating"},/area/acting/backstage)
"al" = (/obj/structure/table/rack,/obj/item/stack/material/wood{amount = 50},/obj/item/stack/material/wood{amount = 50},/obj/item/stack/material/wood{amount = 50},/turf/unsimulated/floor{icon_state = "plating"; name = "plating"},/area/acting/backstage)
"am" = (/obj/structure/table/rack,/obj/item/stack/material/sandstone{amount = 50},/obj/item/stack/material/sandstone{amount = 50},/obj/item/stack/material/sandstone{amount = 50},/turf/unsimulated/floor{icon_state = "plating"; name = "plating"},/area/acting/backstage)
"an" = (/obj/structure/table/rack,/obj/item/stack/material/glass{amount = 50; pixel_x = 3; pixel_y = 3},/obj/item/stack/material/glass{amount = 50; pixel_x = 3; pixel_y = 3},/obj/item/stack/material/glass{amount = 50; pixel_x = 3; pixel_y = 3},/turf/unsimulated/floor{icon_state = "plating"; name = "plating"},/area/acting/backstage)
"ao" = (/obj/structure/table/rack,/obj/item/stack/material/glass/reinforced{amount = 50},/obj/item/stack/material/glass/reinforced{amount = 50},/obj/item/stack/material/glass/reinforced{amount = 50},/turf/unsimulated/floor{icon_state = "plating"; name = "plating"},/area/acting/backstage)
"ap" = (/obj/structure/table/rack,/obj/item/stack/material/marble{amount = 50},/obj/item/stack/material/marble{amount = 50},/obj/item/stack/material/marble{amount = 50},/turf/unsimulated/floor{icon_state = "plating"; name = "plating"},/area/acting/backstage)
"aq" = (/obj/structure/table/rack,/obj/item/stack/material/plastic{amount = 50},/obj/item/stack/material/plastic{amount = 50},/obj/item/stack/material/plastic{amount = 50},/turf/unsimulated/floor{icon_state = "plating"; name = "plating"},/area/acting/backstage)
"ar" = (/obj/structure/table/rack,/obj/item/stack/material/silver{amount = 50},/obj/item/stack/material/silver{amount = 50},/obj/item/stack/material/silver{amount = 50},/turf/unsimulated/floor{icon_state = "plating"; name = "plating"},/area/acting/backstage)
"as" = (/obj/machinery/gibber{anchored = 0},/turf/unsimulated/floor{icon_state = "plating"; name = "plating"},/area/acting/backstage)
"at" = (/obj/machinery/papershredder,/turf/unsimulated/floor{icon_state = "plating"; name = "plating"},/area/acting/backstage)
"au" = (/obj/machinery/recharger,/turf/unsimulated/floor{icon_state = "plating"; name = "plating"},/area/acting/backstage)
"av" = (/obj/machinery/reagentgrinder,/turf/unsimulated/floor{icon_state = "plating"; name = "plating"},/area/acting/backstage)
"aw" = (/obj/structure/reagent_dispensers/watertank,/turf/unsimulated/floor{icon_state = "plating"; name = "plating"},/area/acting/backstage)
"ax" = (/obj/structure/reagent_dispensers/fueltank,/turf/unsimulated/floor{icon_state = "plating"; name = "plating"},/area/acting/backstage)
"ay" = (/turf/unsimulated/floor{icon_state = "plating"; name = "plating"},/area/acting/backstage)
"az" = (/obj/item/weapon/paper{info = "\[center]\[b]READ INSTRUCTIONS CAREFULLY\[/b]\[/center]\[br]\[br]Hello! Welcome and congratulations on being hired for NanoTrasen's new Television initiative. You are now tasked with the creation and production of NanoTrasen brand television that is to be broadcasted to all of our stations!\[br]\[br] We've outfitted these facilities with all the materials and objects you will need.\[br]On the port side you'll find various venders and machines, namely the Wardrobe Dispenser, which will dispense holoclothing and items for you to use, and a Quickee brand plastic surgery machine (which I would remind you you are contractually obligated to \[b]not\[/b] report to the authorities.) which can change your appearance into anything you want, even other races. Stern and aft you'll find all the materials we could muster up on short notice. Use it to decorate the stage to your liking. Starboard you'll find gases, microwaves, hydroponic trays and the like. Go silly! This is already paid for (as are you) so do what you want and entertain!"; name = "Actor's Guild Instruction Pamphlet"},/turf/unsimulated/floor{icon_state = "plating"; name = "plating"},/area/acting/backstage)
"aA" = (/obj/machinery/vending/tool,/turf/unsimulated/floor{icon_state = "plating"; name = "plating"},/area/acting/backstage)
"aB" = (/obj/machinery/door/airlock/glass{name = "Stage"},/turf/simulated/floor,/area/acting/backstage)
"aC" = (/obj/machinery/biogenerator,/turf/unsimulated/floor{icon_state = "plating"; name = "plating"},/area/acting/backstage)
"aD" = (/obj/machinery/vending/hydroseeds,/turf/unsimulated/floor{icon_state = "plating"; name = "plating"},/area/acting/backstage)
"aE" = (/turf/simulated/floor/tiled,/area/acting/stage)
"aF" = (/obj/machinery/light{tag = "icon-tube1 (NORTH)"; icon_state = "tube1"; dir = 1},/turf/simulated/floor/tiled,/area/acting/stage)
"aG" = (/obj/machinery/microwave,/turf/unsimulated/floor{icon_state = "plating"; name = "plating"},/area/acting/backstage)
"aH" = (/obj/machinery/vending/hydronutrients,/turf/unsimulated/floor{icon_state = "plating"; name = "plating"},/area/acting/backstage)
"aI" = (/obj/machinery/vending/medical,/turf/unsimulated/floor{icon_state = "plating"; name = "plating"},/area/acting/backstage)
"aJ" = (/obj/machinery/light{dir = 8},/turf/simulated/floor/tiled,/area/acting/stage)
"aK" = (/obj/machinery/light{dir = 4; icon_state = "tube1"},/turf/simulated/floor/tiled,/area/acting/stage)
"aL" = (/obj/machinery/vending/security,/turf/unsimulated/floor{icon_state = "plating"; name = "plating"},/area/acting/backstage)
"aM" = (/obj/machinery/vending/robotics,/turf/unsimulated/floor{icon_state = "plating"; name = "plating"},/area/acting/backstage)
"aN" = (/obj/machinery/vending/engivend,/turf/unsimulated/floor{icon_state = "plating"; name = "plating"},/area/acting/backstage)
"aO" = (/obj/machinery/camera/network/thunder{anchored = 0; c_tag = "Television"; name = "Movable Camera"},/turf/simulated/floor/tiled,/area/acting/stage)
"aP" = (/obj/machinery/portable_atmospherics/hydroponics,/turf/unsimulated/floor{icon_state = "plating"; name = "plating"},/area/acting/backstage)
"aQ" = (/obj/machinery/vending/dinnerware,/turf/unsimulated/floor{icon_state = "plating"; name = "plating"},/area/acting/backstage)
"aR" = (/obj/machinery/vending/cola{name = "hacked Robust Softdrinks"; prices = list()},/turf/unsimulated/floor{icon_state = "plating"; name = "plating"},/area/acting/backstage)
"aS" = (/obj/machinery/vending/cigarette{name = "hacked cigarette machine"; prices = list(); products = list(/obj/item/weapon/storage/fancy/cigarettes = 10, /obj/item/weapon/storage/box/matches = 10, /obj/item/weapon/flame/lighter/zippo = 4, /obj/item/clothing/mask/smokable/cigarette/cigar/havana = 2)},/turf/unsimulated/floor{icon_state = "plating"; name = "plating"},/area/acting/backstage)
"aT" = (/obj/machinery/chemical_dispenser/bar_alc/full,/turf/unsimulated/floor{icon_state = "plating"; name = "plating"},/area/acting/backstage)
"aU" = (/obj/machinery/vending/containers,/turf/unsimulated/floor{icon_state = "plating"; name = "plating"},/area/acting/backstage)
"aV" = (/obj/machinery/light,/turf/simulated/floor/tiled,/area/acting/stage)
"aW" = (/obj/machinery/chemical_dispenser/full,/turf/unsimulated/floor{icon_state = "plating"; name = "plating"},/area/acting/backstage)
"aX" = (/obj/machinery/pipedispenser,/turf/unsimulated/floor{icon_state = "plating"; name = "plating"},/area/acting/backstage)
"aY" = (/obj/machinery/chemical_dispenser/bar_soft/full,/turf/unsimulated/floor{icon_state = "plating"; name = "plating"},/area/acting/backstage)
"aZ" = (/obj/machinery/acting/changer,/turf/unsimulated/floor{icon_state = "plating"; name = "plating"},/area/acting/backstage)
"ba" = (/obj/machinery/vending/props,/turf/unsimulated/floor{icon_state = "plating"; name = "plating"},/area/acting/backstage)
"bb" = (/obj/machinery/newscaster{pixel_y = -27},/turf/unsimulated/floor{icon_state = "plating"; name = "plating"},/area/acting/backstage)
"bc" = (/obj/structure/table/rack,/obj/item/stack/tile/floor{amount = 50},/turf/unsimulated/floor{icon_state = "plating"; name = "plating"},/area/acting/backstage)
"bd" = (/obj/machinery/portable_atmospherics/canister/phoron,/turf/unsimulated/floor{icon_state = "plating"; name = "plating"},/area/acting/backstage)
"be" = (/obj/machinery/portable_atmospherics/canister/nitrogen,/turf/unsimulated/floor{icon_state = "plating"; name = "plating"},/area/acting/backstage)
"bf" = (/obj/machinery/portable_atmospherics/canister/sleeping_agent,/turf/unsimulated/floor{icon_state = "plating"; name = "plating"},/area/acting/backstage)
"bg" = (/obj/machinery/librarycomp{anchored = 0},/turf/unsimulated/floor{icon_state = "plating"; name = "plating"},/area/acting/backstage)
"bh" = (/turf/unsimulated/wall,/area/centcom/holding)
"bi" = (/obj/machinery/door/airlock/glass_medical{name = "Arrivals Medbay"},/turf/unsimulated/floor{icon_state = "white"},/area/centcom/holding)
"bj" = (/obj/structure/table/standard,/obj/item/weapon/storage/firstaid/regular{pixel_x = 2; pixel_y = 6},/obj/item/weapon/storage/firstaid/regular{pixel_x = -2; pixel_y = 4},/obj/item/weapon/storage/firstaid/adv{pixel_x = 2; pixel_y = 2},/obj/item/weapon/storage/firstaid/adv{pixel_x = -2},/turf/unsimulated/floor{icon_state = "white"},/area/centcom/holding)
"bk" = (/turf/unsimulated/floor{icon_state = "white"},/area/centcom/holding)
"bl" = (/obj/machinery/bodyscanner{dir = 1},/turf/unsimulated/floor{icon_state = "white"},/area/centcom/holding)
"bm" = (/obj/structure/table/standard,/obj/item/weapon/storage/firstaid/o2{layer = 2.8; pixel_x = 4; pixel_y = 6},/obj/item/weapon/storage/firstaid/toxin,/obj/item/weapon/storage/firstaid/fire{layer = 2.9; pixel_x = 2; pixel_y = 3},/obj/machinery/light{dir = 8},/turf/unsimulated/floor{icon_state = "white"},/area/centcom/holding)
"bn" = (/obj/effect/floor_decal/corner/lime{dir = 6},/turf/unsimulated/floor{icon_state = "white"},/area/centcom/holding)
"bo" = (/obj/effect/floor_decal/corner/lime{dir = 9},/turf/unsimulated/floor{icon_state = "white"},/area/centcom/holding)
"bp" = (/obj/machinery/body_scanconsole{tag = "icon-body_scannerconsole (NORTH)"; icon_state = "body_scannerconsole"; dir = 1},/obj/effect/floor_decal/corner/lime{tag = "icon-corner_white (SOUTHWEST)"; icon_state = "corner_white"; dir = 10},/turf/unsimulated/floor{icon_state = "white"},/area/centcom/holding)
"bq" = (/obj/effect/floor_decal/corner/lime{dir = 9},/obj/machinery/hologram/holopad,/turf/unsimulated/floor{icon_state = "white"},/area/centcom/holding)
"br" = (/obj/effect/floor_decal/corner/lime,/turf/unsimulated/floor{icon_state = "white"},/area/centcom/holding)
"bs" = (/obj/machinery/sleeper{dir = 8},/turf/unsimulated/floor{icon_state = "white"},/area/centcom/holding)
"bt" = (/obj/effect/wingrille_spawn/reinforced/crescent,/turf/unsimulated/floor{icon_state = "plating"; name = "plating"},/area/centcom/holding)
"bu" = (/obj/structure/bed/roller,/obj/machinery/camera/network/crescent{c_tag = "Medbayl"; dir = 4},/turf/unsimulated/floor{icon_state = "white"},/area/centcom/holding)
"bv" = (/obj/structure/table/standard,/obj/item/weapon/storage/box/gloves{pixel_x = 3; pixel_y = 4},/obj/item/weapon/storage/box/masks{pixel_x = 0; pixel_y = 0},/obj/machinery/light{dir = 8},/turf/unsimulated/floor{icon_state = "white"},/area/centcom/holding)
"bw" = (/obj/structure/table/standard,/obj/item/clothing/glasses/hud/health,/obj/item/clothing/glasses/hud/health,/obj/item/weapon/reagent_containers/spray/cleaner,/turf/unsimulated/floor{icon_state = "white"},/area/centcom/holding)
"bx" = (/obj/machinery/door/airlock/medical{name = "Operating Theatre"; req_access = list(45)},/turf/unsimulated/floor{icon_state = "white"},/area/centcom/holding)
"by" = (/obj/structure/table/standard,/obj/item/weapon/FixOVein{pixel_x = -6; pixel_y = 1},/turf/unsimulated/floor{icon_state = "white"},/area/centcom/holding)
"bz" = (/obj/structure/table/standard,/obj/item/weapon/retractor{pixel_x = 0; pixel_y = 6},/obj/item/weapon/scalpel,/obj/machinery/camera/network/crescent{c_tag = "Surgery Room"},/turf/unsimulated/floor{icon_state = "white"},/area/centcom/holding)
"bA" = (/obj/structure/table/standard,/obj/item/weapon/bonesetter,/obj/item/weapon/bonegel{pixel_x = 4; pixel_y = 3},/turf/unsimulated/floor{icon_state = "white"},/area/centcom/holding)
"bB" = (/obj/structure/table/standard,/obj/item/weapon/surgicaldrill,/obj/item/weapon/circular_saw,/turf/unsimulated/floor{icon_state = "white"},/area/centcom/holding)
"bC" = (/obj/machinery/light{dir = 8},/turf/unsimulated/floor{icon_state = "white"},/area/centcom/holding)
"bD" = (/obj/effect/floor_decal/corner/lime{tag = "icon-corner_white (SOUTHWEST)"; icon_state = "corner_white"; dir = 10},/turf/unsimulated/floor{icon_state = "white"},/area/centcom/holding)
"bE" = (/obj/effect/floor_decal/corner/lime{tag = "icon-corner_white (SOUTHWEST)"; icon_state = "corner_white"; dir = 10},/obj/machinery/hologram/holopad,/turf/unsimulated/floor{icon_state = "white"},/area/centcom/holding)
"bF" = (/obj/machinery/light{icon_state = "tube1"; dir = 4},/turf/unsimulated/floor{icon_state = "white"},/area/centcom/holding)
"bG" = (/obj/structure/closet/secure_closet/medical2,/turf/unsimulated/floor{icon_state = "white"},/area/centcom/holding)
"bH" = (/obj/machinery/optable,/turf/unsimulated/floor{icon_state = "white"},/area/centcom/holding)
"bI" = (/obj/structure/sink{dir = 4; icon_state = "sink"; pixel_x = 11; pixel_y = 0},/obj/machinery/vending/wallmed1{name = "Emergency NanoMed"; pixel_x = 28},/turf/unsimulated/floor{icon_state = "white"},/area/centcom/holding)
"bJ" = (/obj/structure/table/standard,/obj/item/weapon/storage/box/gloves{pixel_x = 3; pixel_y = 4},/obj/item/weapon/storage/box/masks,/obj/item/weapon/reagent_containers/spray/cleaner,/turf/unsimulated/floor{icon_state = "white"},/area/centcom/holding)
"bK" = (/obj/structure/table/standard,/obj/item/weapon/cautery{pixel_y = 4},/obj/item/weapon/hemostat{pixel_y = 4},/turf/unsimulated/floor{icon_state = "white"},/area/centcom/holding)
"bL" = (/obj/machinery/computer/operating,/turf/unsimulated/floor{icon_state = "white"},/area/centcom/holding)
"bM" = (/obj/machinery/iv_drip,/turf/unsimulated/floor{icon_state = "white"},/area/centcom/holding)
"bN" = (/obj/structure/table/standard,/obj/item/weapon/reagent_containers/blood/OPlus{pixel_x = 4; pixel_y = 2},/obj/item/weapon/reagent_containers/blood/OPlus{pixel_x = 4; pixel_y = 2},/obj/item/weapon/reagent_containers/blood/OMinus{pixel_x = -5; pixel_y = -1},/obj/item/weapon/reagent_containers/blood/OMinus{pixel_x = -5; pixel_y = -1},/turf/unsimulated/floor{icon_state = "white"},/area/centcom/holding)

(1,1,1) = {"
aaaaaaaaaaaaaaaaaaaaaaaaaaaaaaaaaaaaaaaaaaaaaaaaaaaaaaaaabab
aaacacadaeafagahafaiajakalamanaoapaqarasatauavawaxayayaaabab
aaacazayayayayayayayayayayayayayayayayayayayayayayayayaaabab
aaaAayaaaaaaaaaaaaaaaaaaaaaBaaaaaaaaaaaaaaaaaaaaaaayaCaaabab
aaaDayaaaEaEaFaEaEaEaFaEaEaEaEaEaFaEaEaEaEaFaEaEaaayaGaaabab
aaaHayaaaEaEaEaEaEaEaEaEaEaEaEaEaEaEaEaEaEaEaEaEaaayaGaaabab
aaaIayaaaJaEaEaEaEaEaEaEaEaEaEaEaEaEaEaEaEaEaEaKaaayaLaaabab
aaaMayaaaEaEaEaEaEaEaEaEaEaEaEaEaEaEaEaEaEaEaEaEaaayayaaabab
aaaNayaBaEaEaEaEaEaEaEaEaEaOaEaEaEaEaEaEaEaEaEaEaBayaPaaabab
aaaQayaaaEaEaEaEaEaEaEaEaEaEaEaEaEaEaEaEaEaEaEaEaaayaPaaabab
aaaRayaaaJaEaEaEaEaEaEaEaEaEaEaEaEaEaEaEaEaEaEaKaaayaPaaabab
aaaSayaaaEaEaEaEaEaEaEaEaEaEaEaEaEaEaEaEaEaEaEaEaaayaTaaabab
aaaUayaaaEaEaVaEaEaEaVaEaEaEaEaEaVaEaEaEaEaVaEaEaaayaWaaabab
aaaXayaaaaaaaaaaaaaaaaaaaaaBaaaaaaaaaaaaaaaaaaaaaaayaYaaabab
aaaZayayayayayayayayayayayayayayayayayayayayayayayayayaaabab
aababbaebcagahafaiajakalamanaoapaqarbdbebfbgawaxadbbayaaabab
aaaaaaaaaaaaaaaaaaaaaaaaaaaaaaaaaaaaaaaaaaaaaaaaaaaaaaaaabab
bhbhbibibhbhabababababababababababababababababababababababab
bhbjbkbkblbhabababababababababababababababababababababababab
bhbmbnbobpbhbhababababababababababababababababababababababab
bhbkbnbqbrbsbtababababababababababababababababababababababab
bhbubnbobrbsbtababababababababababababababababababababababab
bhbvbnbobrbsbtababababababababababababababababababababababab
bhbwbkbkbrbsbtababababababababababababababababababababababab
bhbhbxbhbhbhbhababababababababababababababababababababababab
bhbybkbzbAbBbhababababababababababababababababababababababab
bhbCbDbEbDbFbhababababababababababababababababababababababab
bhbGbnbHbobIbhababababababababababababababababababababababab
bhbJbKbLbMbNbhababababababababababababababababababababababab
bhbhbhbhbhbhbhababababababababababababababababababababababab
"}
